1048575,1048576,2097151,1048575.000000,1048576.000000,2097151.000000,0
2097150,2097151,4194301,2097150.000000,2097151.000000,4194301.000000,0
3145725,3145726,6291451,3145725.000000,3145726.000000,6291451.000000,0
4194300,4194301,8388601,4194300.000000,4194301.000000,8388601.000000,0
5242875,5242876,10485751,5242875.000000,5242876.000000,10485751.000000,0
6291450,6291451,12582901,6291450.000000,6291451.000000,12582901.000000,0
7340025,7340026,14680051,7340025.000000,7340026.000000,14680051.000000,0
8388600,8388601,16777201,8388600.000000,8388601.000000,16777201.000000,0
9437175,9437176,18874351,9437175.000000,9437176.000000,18874352.000000,1
10485750,10485751,20971501,10485750.000000,10485751.000000,20971500.000000,1
11534325,11534326,23068651,11534325.000000,11534326.000000,23068652.000000,1
12582900,12582901,25165801,12582900.000000,12582901.000000,25165800.000000,1
13631475,13631476,27262951,13631475.000000,13631476.000000,27262952.000000,1
14680050,14680051,29360101,14680050.000000,14680051.000000,29360100.000000,1
15728625,15728626,31457251,15728625.000000,15728626.000000,31457252.000000,1
16777200,16777201,33554401,16777200.000000,16777201.000000,33554400.000000,1
17825775,17825776,35651551,17825776.000000,17825776.000000,35651552.000000,1
18874350,18874351,37748701,18874350.000000,18874352.000000,37748704.000000,3
19922925,19922926,39845851,19922924.000000,19922924.000000,39845848.000000,3
20971500,20971501,41943001,20971500.000000,20971500.000000,41943000.000000,1
22020075,22020076,44040151,22020076.000000,22020076.000000,44040152.000000,1
23068650,23068651,46137301,23068650.000000,23068652.000000,46137304.000000,3
24117225,24117226,48234451,24117224.000000,24117224.000000,48234448.000000,3
25165800,25165801,50331601,25165800.000000,25165800.000000,50331600.000000,1
26214375,26214376,52428751,26214376.000000,26214376.000000,52428752.000000,1
27262950,27262951,54525901,27262950.000000,27262952.000000,54525904.000000,3
28311525,28311526,56623051,28311524.000000,28311524.000000,56623048.000000,3
29360100,29360101,58720201,29360100.000000,29360100.000000,58720200.000000,1
30408675,30408676,60817351,30408676.000000,30408676.000000,60817352.000000,1
31457250,31457251,62914501,31457250.000000,31457252.000000,62914504.000000,3
32505825,32505826,65011651,32505824.000000,32505824.000000,65011648.000000,3
33554400,33554401,67108801,33554400.000000,33554400.000000,67108800.000000,1
34602975,34602976,69205951,34602976.000000,34602976.000000,69205952.000000,1
35651550,35651551,71303101,35651552.000000,35651552.000000,71303104.000000,3
36700125,36700126,73400251,36700124.000000,36700124.000000,73400248.000000,3
37748700,37748701,75497401,37748700.000000,37748700.000000,75497400.000000,1
38797275,38797276,77594551,38797276.000000,38797276.000000,77594552.000000,1
39845850,39845851,79691701,39845848.000000,39845848.000000,79691696.000000,5
40894425,40894426,81788851,40894424.000000,40894424.000000,81788848.000000,3
41943000,41943001,83886001,41943000.000000,41943000.000000,83886000.000000,1
42991575,42991576,85983151,42991576.000000,42991576.000000,85983152.000000,1
44040150,44040151,88080301,44040152.000000,44040152.000000,88080304.000000,3
45088725,45088726,90177451,45088724.000000,45088724.000000,90177448.000000,3
46137300,46137301,92274601,46137300.000000,46137300.000000,92274600.000000,1
47185875,47185876,94371751,47185876.000000,47185876.000000,94371752.000000,1
48234450,48234451,96468901,48234448.000000,48234448.000000,96468896.000000,5
49283025,49283026,98566051,49283024.000000,49283024.000000,98566048.000000,3
50331600,50331601,100663201,50331600.000000,50331600.000000,100663200.000000,1
51380175,51380176,102760351,51380176.000000,51380176.000000,102760352.000000,1
52428750,52428751,104857501,52428752.000000,52428752.000000,104857504.000000,3
53477325,53477326,106954651,53477324.000000,53477324.000000,106954648.000000,3
54525900,54525901,109051801,54525900.000000,54525900.000000,109051800.000000,1
55574475,55574476,111148951,55574476.000000,55574476.000000,111148952.000000,1
56623050,56623051,113246101,56623048.000000,56623048.000000,113246096.000000,5
57671625,57671626,115343251,57671624.000000,57671624.000000,115343248.000000,3
58720200,58720201,117440401,58720200.000000,58720200.000000,117440400.000000,1
59768775,59768776,119537551,59768776.000000,59768776.000000,119537552.000000,1
60817350,60817351,121634701,60817352.000000,60817352.000000,121634704.000000,3
61865925,61865926,123731851,61865924.000000,61865924.000000,123731848.000000,3
62914500,62914501,125829001,62914500.000000,62914500.000000,125829000.000000,1
63963075,63963076,127926151,63963076.000000,63963076.000000,127926152.000000,1
65011650,65011651,130023301,65011648.000000,65011648.000000,130023296.000000,5
66060225,66060226,132120451,66060224.000000,66060224.000000,132120448.000000,3
67108800,67108801,134217601,67108800.000000,67108800.000000,134217600.000000,1
68157375,68157376,136314751,68157376.000000,68157376.000000,136314752.000000,1
69205950,69205951,138411901,69205952.000000,69205952.000000,138411904.000000,3
70254525,70254526,140509051,70254528.000000,70254528.000000,140509056.000000,5
71303100,71303101,142606201,71303104.000000,71303104.000000,142606208.000000,7
72351675,72351676,144703351,72351672.000000,72351672.000000,144703344.000000,7
73400250,73400251,146800501,73400248.000000,73400248.000000,146800496.000000,5
74448825,74448826,148897651,74448824.000000,74448824.000000,148897648.000000,3
75497400,75497401,150994801,75497400.000000,75497400.000000,150994800.000000,1
76545975,76545976,153091951,76545976.000000,76545976.000000,153091952.000000,1
77594550,77594551,155189101,77594552.000000,77594552.000000,155189104.000000,3
78643125,78643126,157286251,78643128.000000,78643128.000000,157286256.000000,5
79691700,79691701,159383401,79691696.000000,79691696.000000,159383392.000000,9
80740275,80740276,161480551,80740272.000000,80740272.000000,161480544.000000,7
81788850,81788851,163577701,81788848.000000,81788848.000000,163577696.000000,5
82837425,82837426,165674851,82837424.000000,82837424.000000,165674848.000000,3
83886000,83886001,167772001,83886000.000000,83886000.000000,167772000.000000,1
84934575,84934576,169869151,84934576.000000,84934576.000000,169869152.000000,1
85983150,85983151,171966301,85983152.000000,85983152.000000,171966304.000000,3
87031725,87031726,174063451,87031728.000000,87031728.000000,174063456.000000,5
88080300,88080301,176160601,88080304.000000,88080304.000000,176160608.000000,7
89128875,89128876,178257751,89128872.000000,89128872.000000,178257744.000000,7
90177450,90177451,180354901,90177448.000000,90177448.000000,180354896.000000,5
91226025,91226026,182452051,91226024.000000,91226024.000000,182452048.000000,3
92274600,92274601,184549201,92274600.000000,92274600.000000,184549200.000000,1
93323175,93323176,186646351,93323176.000000,93323176.000000,186646352.000000,1
94371750,94371751,188743501,94371752.000000,94371752.000000,188743504.000000,3
95420325,95420326,190840651,95420328.000000,95420328.000000,190840656.000000,5
96468900,96468901,192937801,96468896.000000,96468896.000000,192937792.000000,9
97517475,97517476,195034951,97517472.000000,97517472.000000,195034944.000000,7
98566050,98566051,197132101,98566048.000000,98566048.000000,197132096.000000,5
99614625,99614626,199229251,99614624.000000,99614624.000000,199229248.000000,3
100663200,100663201,201326401,100663200.000000,100663200.000000,201326400.000000,1
101711775,101711776,203423551,101711776.000000,101711776.000000,203423552.000000,1
102760350,102760351,205520701,102760352.000000,102760352.000000,205520704.000000,3
103808925,103808926,207617851,103808928.000000,103808928.000000,207617856.000000,5
104857500,104857501,209715001,104857504.000000,104857504.000000,209715008.000000,7
105906075,105906076,211812151,105906072.000000,105906072.000000,211812144.000000,7
106954650,106954651,213909301,106954648.000000,106954648.000000,213909296.000000,5
108003225,108003226,216006451,108003224.000000,108003224.000000,216006448.000000,3
109051800,109051801,218103601,109051800.000000,109051800.000000,218103600.000000,1
110100375,110100376,220200751,110100376.000000,110100376.000000,220200752.000000,1
111148950,111148951,222297901,111148952.000000,111148952.000000,222297904.000000,3
112197525,112197526,224395051,112197528.000000,112197528.000000,224395056.000000,5
113246100,113246101,226492201,113246096.000000,113246096.000000,226492192.000000,9
114294675,114294676,228589351,114294672.000000,114294672.000000,228589344.000000,7
115343250,115343251,230686501,115343248.000000,115343248.000000,230686496.000000,5
116391825,116391826,232783651,116391824.000000,116391824.000000,232783648.000000,3
117440400,117440401,234880801,117440400.000000,117440400.000000,234880800.000000,1
118488975,118488976,236977951,118488976.000000,118488976.000000,236977952.000000,1
119537550,119537551,239075101,119537552.000000,119537552.000000,239075104.000000,3
120586125,120586126,241172251,120586128.000000,120586128.000000,241172256.000000,5
121634700,121634701,243269401,121634704.000000,121634704.000000,243269408.000000,7
122683275,122683276,245366551,122683272.000000,122683272.000000,245366544.000000,7
123731850,123731851,247463701,123731848.000000,123731848.000000,247463696.000000,5
124780425,124780426,249560851,124780424.000000,124780424.000000,249560848.000000,3
125829000,125829001,251658001,125829000.000000,125829000.000000,251658000.000000,1
126877575,126877576,253755151,126877576.000000,126877576.000000,253755152.000000,1
127926150,127926151,255852301,127926152.000000,127926152.000000,255852304.000000,3
128974725,128974726,257949451,128974728.000000,128974728.000000,257949456.000000,5
130023300,130023301,260046601,130023296.000000,130023296.000000,260046592.000000,9
131071875,131071876,262143751,131071872.000000,131071872.000000,262143744.000000,7
132120450,132120451,264240901,132120448.000000,132120448.000000,264240896.000000,5
133169025,133169026,266338051,133169024.000000,133169024.000000,266338048.000000,3
134217600,134217601,268435201,134217600.000000,134217600.000000,268435200.000000,1
135266175,135266176,270532351,135266176.000000,135266176.000000,270532352.000000,1
136314750,136314751,272629501,136314752.000000,136314752.000000,272629504.000000,3
137363325,137363326,274726651,137363328.000000,137363328.000000,274726656.000000,5
138411900,138411901,276823801,138411904.000000,138411904.000000,276823808.000000,7
139460475,139460476,278920951,139460480.000000,139460480.000000,278920960.000000,9
140509050,140509051,281018101,140509056.000000,140509056.000000,281018112.000000,11
141557625,141557626,283115251,141557632.000000,141557632.000000,283115264.000000,13
142606200,142606201,285212401,142606208.000000,142606208.000000,285212416.000000,15
143654775,143654776,287309551,143654768.000000,143654768.000000,287309536.000000,15
144703350,144703351,289406701,144703344.000000,144703344.000000,289406688.000000,13
145751925,145751926,291503851,145751920.000000,145751920.000000,291503840.000000,11
146800500,146800501,293601001,146800496.000000,146800496.000000,293600992.000000,9
147849075,147849076,295698151,147849072.000000,147849072.000000,295698144.000000,7
148897650,148897651,297795301,148897648.000000,148897648.000000,297795296.000000,5
149946225,149946226,299892451,149946224.000000,149946224.000000,299892448.000000,3
150994800,150994801,301989601,150994800.000000,150994800.000000,301989600.000000,1
152043375,152043376,304086751,152043376.000000,152043376.000000,304086752.000000,1
153091950,153091951,306183901,153091952.000000,153091952.000000,306183904.000000,3
154140525,154140526,308281051,154140528.000000,154140528.000000,308281056.000000,5
155189100,155189101,310378201,155189104.000000,155189104.000000,310378208.000000,7
156237675,156237676,312475351,156237680.000000,156237680.000000,312475360.000000,9
157286250,157286251,314572501,157286256.000000,157286256.000000,314572512.000000,11
158334825,158334826,316669651,158334832.000000,158334832.000000,316669664.000000,13
159383400,159383401,318766801,159383392.000000,159383392.000000,318766784.000000,17
160431975,160431976,320863951,160431968.000000,160431968.000000,320863936.000000,15
161480550,161480551,322961101,161480544.000000,161480544.000000,322961088.000000,13
162529125,162529126,325058251,162529120.000000,162529120.000000,325058240.000000,11
163577700,163577701,327155401,163577696.000000,163577696.000000,327155392.000000,9
164626275,164626276,329252551,164626272.000000,164626272.000000,329252544.000000,7
165674850,165674851,331349701,165674848.000000,165674848.000000,331349696.000000,5
166723425,166723426,333446851,166723424.000000,166723424.000000,333446848.000000,3
167772000,167772001,335544001,167772000.000000,167772000.000000,335544000.000000,1
168820575,168820576,337641151,168820576.000000,168820576.000000,337641152.000000,1
169869150,169869151,339738301,169869152.000000,169869152.000000,339738304.000000,3
170917725,170917726,341835451,170917728.000000,170917728.000000,341835456.000000,5
171966300,171966301,343932601,171966304.000000,171966304.000000,343932608.000000,7
173014875,173014876,346029751,173014880.000000,173014880.000000,346029760.000000,9
174063450,174063451,348126901,174063456.000000,174063456.000000,348126912.000000,11
175112025,175112026,350224051,175112032.000000,175112032.000000,350224064.000000,13
176160600,176160601,352321201,176160608.000000,176160608.000000,352321216.000000,15
177209175,177209176,354418351,177209168.000000,177209168.000000,354418336.000000,15
178257750,178257751,356515501,178257744.000000,178257744.000000,356515488.000000,13
179306325,179306326,358612651,179306320.000000,179306320.000000,358612640.000000,11
180354900,180354901,360709801,180354896.000000,180354896.000000,360709792.000000,9
181403475,181403476,362806951,181403472.000000,181403472.000000,362806944.000000,7
182452050,182452051,364904101,182452048.000000,182452048.000000,364904096.000000,5
183500625,183500626,367001251,183500624.000000,183500624.000000,367001248.000000,3
184549200,184549201,369098401,184549200.000000,184549200.000000,369098400.000000,1
185597775,185597776,371195551,185597776.000000,185597776.000000,371195552.000000,1
186646350,186646351,373292701,186646352.000000,186646352.000000,373292704.000000,3
187694925,187694926,375389851,187694928.000000,187694928.000000,375389856.000000,5
188743500,188743501,377487001,188743504.000000,188743504.000000,377487008.000000,7
189792075,189792076,379584151,189792080.000000,189792080.000000,379584160.000000,9
190840650,190840651,381681301,190840656.000000,190840656.000000,381681312.000000,11
191889225,191889226,383778451,191889232.000000,191889232.000000,383778464.000000,13
192937800,192937801,385875601,192937792.000000,192937792.000000,385875584.000000,17
193986375,193986376,387972751,193986368.000000,193986368.000000,387972736.000000,15
195034950,195034951,390069901,195034944.000000,195034944.000000,390069888.000000,13
196083525,196083526,392167051,196083520.000000,196083520.000000,392167040.000000,11
197132100,197132101,394264201,197132096.000000,197132096.000000,394264192.000000,9
198180675,198180676,396361351,198180672.000000,198180672.000000,396361344.000000,7
199229250,199229251,398458501,199229248.000000,199229248.000000,398458496.000000,5
200277825,200277826,400555651,200277824.000000,200277824.000000,400555648.000000,3
201326400,201326401,402652801,201326400.000000,201326400.000000,402652800.000000,1
202374975,202374976,404749951,202374976.000000,202374976.000000,404749952.000000,1
203423550,203423551,406847101,203423552.000000,203423552.000000,406847104.000000,3
204472125,204472126,408944251,204472128.000000,204472128.000000,408944256.000000,5
205520700,205520701,411041401,205520704.000000,205520704.000000,411041408.000000,7
206569275,206569276,413138551,206569280.000000,206569280.000000,413138560.000000,9
207617850,207617851,415235701,207617856.000000,207617856.000000,415235712.000000,11
208666425,208666426,417332851,208666432.000000,208666432.000000,417332864.000000,13
209715000,209715001,419430001,209715008.000000,209715008.000000,419430016.000000,15
210763575,210763576,421527151,210763568.000000,210763568.000000,421527136.000000,15
211812150,211812151,423624301,211812144.000000,211812144.000000,423624288.000000,13
212860725,212860726,425721451,212860720.000000,212860720.000000,425721440.000000,11
213909300,213909301,427818601,213909296.000000,213909296.000000,427818592.000000,9
214957875,214957876,429915751,214957872.000000,214957872.000000,429915744.000000,7
216006450,216006451,432012901,216006448.000000,216006448.000000,432012896.000000,5
217055025,217055026,434110051,217055024.000000,217055024.000000,434110048.000000,3
218103600,218103601,436207201,218103600.000000,218103600.000000,436207200.000000,1
219152175,219152176,438304351,219152176.000000,219152176.000000,438304352.000000,1
220200750,220200751,440401501,220200752.000000,220200752.000000,440401504.000000,3
221249325,221249326,442498651,221249328.000000,221249328.000000,442498656.000000,5
222297900,222297901,444595801,222297904.000000,222297904.000000,444595808.000000,7
223346475,223346476,446692951,223346480.000000,223346480.000000,446692960.000000,9
224395050,224395051,448790101,224395056.000000,224395056.000000,448790112.000000,11
225443625,225443626,450887251,225443632.000000,225443632.000000,450887264.000000,13
226492200,226492201,452984401,226492192.000000,226492192.000000,452984384.000000,17
227540775,227540776,455081551,227540768.000000,227540768.000000,455081536.000000,15
228589350,228589351,457178701,228589344.000000,228589344.000000,457178688.000000,13
229637925,229637926,459275851,229637920.000000,229637920.000000,459275840.000000,11
230686500,230686501,461373001,230686496.000000,230686496.000000,461372992.000000,9
231735075,231735076,463470151,231735072.000000,231735072.000000,463470144.000000,7
232783650,232783651,465567301,232783648.000000,232783648.000000,465567296.000000,5
233832225,233832226,467664451,233832224.000000,233832224.000000,467664448.000000,3
234880800,234880801,469761601,234880800.000000,234880800.000000,469761600.000000,1
235929375,235929376,471858751,235929376.000000,235929376.000000,471858752.000000,1
236977950,236977951,473955901,236977952.000000,236977952.000000,473955904.000000,3
238026525,238026526,476053051,238026528.000000,238026528.000000,476053056.000000,5
239075100,239075101,478150201,239075104.000000,239075104.000000,478150208.000000,7
240123675,240123676,480247351,240123680.000000,240123680.000000,480247360.000000,9
241172250,241172251,482344501,241172256.000000,241172256.000000,482344512.000000,11
242220825,242220826,484441651,242220832.000000,242220832.000000,484441664.000000,13
243269400,243269401,486538801,243269408.000000,243269408.000000,486538816.000000,15
244317975,244317976,488635951,244317968.000000,244317968.000000,488635936.000000,15
245366550,245366551,490733101,245366544.000000,245366544.000000,490733088.000000,13
246415125,246415126,492830251,246415120.000000,246415120.000000,492830240.000000,11
247463700,247463701,494927401,247463696.000000,247463696.000000,494927392.000000,9
248512275,248512276,497024551,248512272.000000,248512272.000000,497024544.000000,7
249560850,249560851,499121701,249560848.000000,249560848.000000,499121696.000000,5
250609425,250609426,501218851,250609424.000000,250609424.000000,501218848.000000,3
251658000,251658001,503316001,251658000.000000,251658000.000000,503316000.000000,1
252706575,252706576,505413151,252706576.000000,252706576.000000,505413152.000000,1
253755150,253755151,507510301,253755152.000000,253755152.000000,507510304.000000,3
254803725,254803726,509607451,254803728.000000,254803728.000000,509607456.000000,5
255852300,255852301,511704601,255852304.000000,255852304.000000,511704608.000000,7
256900875,256900876,513801751,256900880.000000,256900880.000000,513801760.000000,9
257949450,257949451,515898901,257949456.000000,257949456.000000,515898912.000000,11
258998025,258998026,517996051,258998032.000000,258998032.000000,517996064.000000,13
260046600,260046601,520093201,260046592.000000,260046592.000000,520093184.000000,17
261095175,261095176,522190351,261095168.000000,261095168.000000,522190336.000000,15
262143750,262143751,524287501,262143744.000000,262143744.000000,524287488.000000,13
263192325,263192326,526384651,263192320.000000,263192320.000000,526384640.000000,11
264240900,264240901,528481801,264240896.000000,264240896.000000,528481792.000000,9
265289475,265289476,530578951,265289472.000000,265289472.000000,530578944.000000,7
266338050,266338051,532676101,266338048.000000,266338048.000000,532676096.000000,5
267386625,267386626,534773251,267386624.000000,267386624.000000,534773248.000000,3
268435200,268435201,536870401,268435200.000000,268435200.000000,536870400.000000,1
269483775,269483776,538967551,269483776.000000,269483776.000000,538967552.000000,1
270532350,270532351,541064701,270532352.000000,270532352.000000,541064704.000000,3
271580925,271580926,543161851,271580928.000000,271580928.000000,543161856.000000,5
272629500,272629501,545259001,272629504.000000,272629504.000000,545259008.000000,7
273678075,273678076,547356151,273678080.000000,273678080.000000,547356160.000000,9
274726650,274726651,549453301,274726656.000000,274726656.000000,549453312.000000,11
275775225,275775226,551550451,275775232.000000,275775232.000000,551550464.000000,13
276823800,276823801,553647601,276823808.000000,276823808.000000,553647616.000000,15
277872375,277872376,555744751,277872384.000000,277872384.000000,555744768.000000,17
278920950,278920951,557841901,278920960.000000,278920960.000000,557841920.000000,19
279969525,279969526,559939051,279969536.000000,279969536.000000,559939072.000000,21
281018100,281018101,562036201,281018112.000000,281018112.000000,562036224.000000,23
282066675,282066676,564133351,282066688.000000,282066688.000000,564133376.000000,25
283115250,283115251,566230501,283115264.000000,283115264.000000,566230528.000000,27
284163825,284163826,568327651,284163840.000000,284163840.000000,568327680.000000,29
285212400,285212401,570424801,285212416.000000,285212416.000000,570424832.000000,31
286260975,286260976,572521951,286260960.000000,286260960.000000,572521920.000000,31
287309550,287309551,574619101,287309536.000000,287309536.000000,574619072.000000,29
288358125,288358126,576716251,288358112.000000,288358112.000000,576716224.000000,27
289406700,289406701,578813401,289406688.000000,289406688.000000,578813376.000000,25
290455275,290455276,580910551,290455264.000000,290455264.000000,580910528.000000,23
291503850,291503851,583007701,291503840.000000,291503840.000000,583007680.000000,21
292552425,292552426,585104851,292552416.000000,292552416.000000,585104832.000000,19
293601000,293601001,587202001,293600992.000000,293600992.000000,587201984.000000,17
294649575,294649576,589299151,294649568.000000,294649568.000000,589299136.000000,15
295698150,295698151,591396301,295698144.000000,295698144.000000,591396288.000000,13
296746725,296746726,593493451,296746720.000000,296746720.000000,593493440.000000,11
297795300,297795301,595590601,297795296.000000,297795296.000000,595590592.000000,9
298843875,298843876,597687751,298843872.000000,298843872.000000,597687744.000000,7
299892450,299892451,599784901,299892448.000000,299892448.000000,599784896.000000,5
300941025,300941026,601882051,300941024.000000,300941024.000000,601882048.000000,3
301989600,301989601,603979201,301989600.000000,301989600.000000,603979200.000000,1
303038175,303038176,606076351,303038176.000000,303038176.000000,606076352.000000,1
304086750,304086751,608173501,304086752.000000,304086752.000000,608173504.000000,3
305135325,305135326,610270651,305135328.000000,305135328.000000,610270656.000000,5
306183900,306183901,612367801,306183904.000000,306183904.000000,612367808.000000,7
307232475,307232476,614464951,307232480.000000,307232480.000000,614464960.000000,9
308281050,308281051,616562101,308281056.000000,308281056.000000,616562112.000000,11
309329625,309329626,618659251,309329632.000000,309329632.000000,618659264.000000,13
310378200,310378201,620756401,310378208.000000,310378208.000000,620756416.000000,15
311426775,311426776,622853551,311426784.000000,311426784.000000,622853568.000000,17
312475350,312475351,624950701,312475360.000000,312475360.000000,624950720.000000,19
313523925,313523926,627047851,313523936.000000,313523936.000000,627047872.000000,21
314572500,314572501,629145001,314572512.000000,314572512.000000,629145024.000000,23
315621075,315621076,631242151,315621088.000000,315621088.000000,631242176.000000,25
316669650,316669651,633339301,316669664.000000,316669664.000000,633339328.000000,27
317718225,317718226,635436451,317718240.000000,317718240.000000,635436480.000000,29
318766800,318766801,637533601,318766784.000000,318766784.000000,637533568.000000,33
319815375,319815376,639630751,319815360.000000,319815360.000000,639630720.000000,31
320863950,320863951,641727901,320863936.000000,320863936.000000,641727872.000000,29
321912525,321912526,643825051,321912512.000000,321912512.000000,643825024.000000,27
322961100,322961101,645922201,322961088.000000,322961088.000000,645922176.000000,25
324009675,324009676,648019351,324009664.000000,324009664.000000,648019328.000000,23
325058250,325058251,650116501,325058240.000000,325058240.000000,650116480.000000,21
326106825,326106826,652213651,326106816.000000,326106816.000000,652213632.000000,19
327155400,327155401,654310801,327155392.000000,327155392.000000,654310784.000000,17
328203975,328203976,656407951,328203968.000000,328203968.000000,656407936.000000,15
329252550,329252551,658505101,329252544.000000,329252544.000000,658505088.000000,13
330301125,330301126,660602251,330301120.000000,330301120.000000,660602240.000000,11
331349700,331349701,662699401,331349696.000000,331349696.000000,662699392.000000,9
332398275,332398276,664796551,332398272.000000,332398272.000000,664796544.000000,7
333446850,333446851,666893701,333446848.000000,333446848.000000,666893696.000000,5
334495425,334495426,668990851,334495424.000000,334495424.000000,668990848.000000,3
335544000,335544001,671088001,335544000.000000,335544000.000000,671088000.000000,1
336592575,336592576,673185151,336592576.000000,336592576.000000,673185152.000000,1
337641150,337641151,675282301,337641152.000000,337641152.000000,675282304.000000,3
338689725,338689726,677379451,338689728.000000,338689728.000000,677379456.000000,5
339738300,339738301,679476601,339738304.000000,339738304.000000,679476608.000000,7
340786875,340786876,681573751,340786880.000000,340786880.000000,681573760.000000,9
341835450,341835451,683670901,341835456.000000,341835456.000000,683670912.000000,11
342884025,342884026,685768051,342884032.000000,342884032.000000,685768064.000000,13
343932600,343932601,687865201,343932608.000000,343932608.000000,687865216.000000,15
344981175,344981176,689962351,344981184.000000,344981184.000000,689962368.000000,17
346029750,346029751,692059501,346029760.000000,346029760.000000,692059520.000000,19
347078325,347078326,694156651,347078336.000000,347078336.000000,694156672.000000,21
348126900,348126901,696253801,348126912.000000,348126912.000000,696253824.000000,23
349175475,349175476,698350951,349175488.000000,349175488.000000,698350976.000000,25
350224050,350224051,700448101,350224064.000000,350224064.000000,700448128.000000,27
351272625,351272626,702545251,351272640.000000,351272640.000000,702545280.000000,29
352321200,352321201,704642401,352321216.000000,352321216.000000,704642432.000000,31
353369775,353369776,706739551,353369760.000000,353369760.000000,706739520.000000,31
354418350,354418351,708836701,354418336.000000,354418336.000000,708836672.000000,29
355466925,355466926,710933851,355466912.000000,355466912.000000,710933824.000000,27
356515500,356515501,713031001,356515488.000000,356515488.000000,713030976.000000,25
357564075,357564076,715128151,357564064.000000,357564064.000000,715128128.000000,23
358612650,358612651,717225301,358612640.000000,358612640.000000,717225280.000000,21
359661225,359661226,719322451,359661216.000000,359661216.000000,719322432.000000,19
360709800,360709801,721419601,360709792.000000,360709792.000000,721419584.000000,17
361758375,361758376,723516751,361758368.000000,361758368.000000,723516736.000000,15
362806950,362806951,725613901,362806944.000000,362806944.000000,725613888.000000,13
363855525,363855526,727711051,363855520.000000,363855520.000000,727711040.000000,11
364904100,364904101,729808201,364904096.000000,364904096.000000,729808192.000000,9
365952675,365952676,731905351,365952672.000000,365952672.000000,731905344.000000,7
367001250,367001251,734002501,367001248.000000,367001248.000000,734002496.000000,5
368049825,368049826,736099651,368049824.000000,368049824.000000,736099648.000000,3
369098400,369098401,738196801,369098400.000000,369098400.000000,738196800.000000,1
370146975,370146976,740293951,370146976.000000,370146976.000000,740293952.000000,1
371195550,371195551,742391101,371195552.000000,371195552.000000,742391104.000000,3
372244125,372244126,744488251,372244128.000000,372244128.000000,744488256.000000,5
373292700,373292701,746585401,373292704.000000,373292704.000000,746585408.000000,7
374341275,374341276,748682551,374341280.000000,374341280.000000,748682560.000000,9
375389850,375389851,750779701,375389856.000000,375389856.000000,750779712.000000,11
376438425,376438426,752876851,376438432.000000,376438432.000000,752876864.000000,13
377487000,377487001,754974001,377487008.000000,377487008.000000,754974016.000000,15
378535575,378535576,757071151,378535584.000000,378535584.000000,757071168.000000,17
379584150,379584151,759168301,379584160.000000,379584160.000000,759168320.000000,19
380632725,380632726,761265451,380632736.000000,380632736.000000,761265472.000000,21
381681300,381681301,763362601,381681312.000000,381681312.000000,763362624.000000,23
382729875,382729876,765459751,382729888.000000,382729888.000000,765459776.000000,25
383778450,383778451,767556901,383778464.000000,383778464.000000,767556928.000000,27
384827025,384827026,769654051,384827040.000000,384827040.000000,769654080.000000,29
385875600,385875601,771751201,385875584.000000,385875584.000000,771751168.000000,33
386924175,386924176,773848351,386924160.000000,386924160.000000,773848320.000000,31
387972750,387972751,775945501,387972736.000000,387972736.000000,775945472.000000,29
389021325,389021326,778042651,389021312.000000,389021312.000000,778042624.000000,27
390069900,390069901,780139801,390069888.000000,390069888.000000,780139776.000000,25
391118475,391118476,782236951,391118464.000000,391118464.000000,782236928.000000,23
392167050,392167051,784334101,392167040.000000,392167040.000000,784334080.000000,21
393215625,393215626,786431251,393215616.000000,393215616.000000,786431232.000000,19
394264200,394264201,788528401,394264192.000000,394264192.000000,788528384.000000,17
395312775,395312776,790625551,395312768.000000,395312768.000000,790625536.000000,15
396361350,396361351,792722701,396361344.000000,396361344.000000,792722688.000000,13
397409925,397409926,794819851,397409920.000000,397409920.000000,794819840.000000,11
398458500,398458501,796917001,398458496.000000,398458496.000000,796916992.000000,9
399507075,399507076,799014151,399507072.000000,399507072.000000,799014144.000000,7
400555650,400555651,801111301,400555648.000000,400555648.000000,801111296.000000,5
401604225,401604226,803208451,401604224.000000,401604224.000000,803208448.000000,3
402652800,402652801,805305601,402652800.000000,402652800.000000,805305600.000000,1
403701375,403701376,807402751,403701376.000000,403701376.000000,807402752.000000,1
404749950,404749951,809499901,404749952.000000,404749952.000000,809499904.000000,3
405798525,405798526,811597051,405798528.000000,405798528.000000,811597056.000000,5
406847100,406847101,813694201,406847104.000000,406847104.000000,813694208.000000,7
407895675,407895676,815791351,407895680.000000,407895680.000000,815791360.000000,9
408944250,408944251,817888501,408944256.000000,408944256.000000,817888512.000000,11
409992825,409992826,819985651,409992832.000000,409992832.000000,819985664.000000,13
411041400,411041401,822082801,411041408.000000,411041408.000000,822082816.000000,15
412089975,412089976,824179951,412089984.000000,412089984.000000,824179968.000000,17
413138550,413138551,826277101,413138560.000000,413138560.000000,826277120.000000,19
414187125,414187126,828374251,414187136.000000,414187136.000000,828374272.000000,21
415235700,415235701,830471401,415235712.000000,415235712.000000,830471424.000000,23
416284275,416284276,832568551,416284288.000000,416284288.000000,832568576.000000,25
417332850,417332851,834665701,417332864.000000,417332864.000000,834665728.000000,27
418381425,418381426,836762851,418381440.000000,418381440.000000,836762880.000000,29
419430000,419430001,838860001,419430016.000000,419430016.000000,838860032.000000,31
420478575,420478576,840957151,420478560.000000,420478560.000000,840957120.000000,31
421527150,421527151,843054301,421527136.000000,421527136.000000,843054272.000000,29
422575725,422575726,845151451,422575712.000000,422575712.000000,845151424.000000,27
423624300,423624301,847248601,423624288.000000,423624288.000000,847248576.000000,25
424672875,424672876,849345751,424672864.000000,424672864.000000,849345728.000000,23
425721450,425721451,851442901,425721440.000000,425721440.000000,851442880.000000,21
426770025,426770026,853540051,426770016.000000,426770016.000000,853540032.000000,19
427818600,427818601,855637201,427818592.000000,427818592.000000,855637184.000000,17
428867175,428867176,857734351,428867168.000000,428867168.000000,857734336.000000,15
429915750,429915751,859831501,429915744.000000,429915744.000000,859831488.000000,13
430964325,430964326,861928651,430964320.000000,430964320.000000,861928640.000000,11
432012900,432012901,864025801,432012896.000000,432012896.000000,864025792.000000,9
433061475,433061476,866122951,433061472.000000,433061472.000000,866122944.000000,7
434110050,434110051,868220101,434110048.000000,434110048.000000,868220096.000000,5
435158625,435158626,870317251,435158624.000000,435158624.000000,870317248.000000,3
436207200,436207201,872414401,436207200.000000,436207200.000000,872414400.000000,1
437255775,437255776,874511551,437255776.000000,437255776.000000,874511552.000000,1
438304350,438304351,876608701,438304352.000000,438304352.000000,876608704.000000,3
439352925,439352926,878705851,439352928.000000,439352928.000000,878705856.000000,5
440401500,440401501,880803001,440401504.000000,440401504.000000,880803008.000000,7
441450075,441450076,882900151,441450080.000000,441450080.000000,882900160.000000,9
442498650,442498651,884997301,442498656.000000,442498656.000000,884997312.000000,11
443547225,443547226,887094451,443547232.000000,443547232.000000,887094464.000000,13
444595800,444595801,889191601,444595808.000000,444595808.000000,889191616.000000,15
445644375,445644376,891288751,445644384.000000,445644384.000000,891288768.000000,17
446692950,446692951,893385901,446692960.000000,446692960.000000,893385920.000000,19
447741525,447741526,895483051,447741536.000000,447741536.000000,895483072.000000,21
448790100,448790101,897580201,448790112.000000,448790112.000000,897580224.000000,23
449838675,449838676,899677351,449838688.000000,449838688.000000,899677376.000000,25
450887250,450887251,901774501,450887264.000000,450887264.000000,901774528.000000,27
451935825,451935826,903871651,451935840.000000,451935840.000000,903871680.000000,29
452984400,452984401,905968801,452984384.000000,452984384.000000,905968768.000000,33
454032975,454032976,908065951,454032960.000000,454032960.000000,908065920.000000,31
455081550,455081551,910163101,455081536.000000,455081536.000000,910163072.000000,29
456130125,456130126,912260251,456130112.000000,456130112.000000,912260224.000000,27
457178700,457178701,914357401,457178688.000000,457178688.000000,914357376.000000,25
458227275,458227276,916454551,458227264.000000,458227264.000000,916454528.000000,23
459275850,459275851,918551701,459275840.000000,459275840.000000,918551680.000000,21
460324425,460324426,920648851,460324416.000000,460324416.000000,920648832.000000,19
461373000,461373001,922746001,461372992.000000,461372992.000000,922745984.000000,17
462421575,462421576,924843151,462421568.000000,462421568.000000,924843136.000000,15
463470150,463470151,926940301,463470144.000000,463470144.000000,926940288.000000,13
464518725,464518726,929037451,464518720.000000,464518720.000000,929037440.000000,11
465567300,465567301,931134601,465567296.000000,465567296.000000,931134592.000000,9
466615875,466615876,933231751,466615872.000000,466615872.000000,933231744.000000,7
467664450,467664451,935328901,467664448.000000,467664448.000000,935328896.000000,5
468713025,468713026,937426051,468713024.000000,468713024.000000,937426048.000000,3
469761600,469761601,939523201,469761600.000000,469761600.000000,939523200.000000,1
470810175,470810176,941620351,470810176.000000,470810176.000000,941620352.000000,1
471858750,471858751,943717501,471858752.000000,471858752.000000,943717504.000000,3
472907325,472907326,945814651,472907328.000000,472907328.000000,945814656.000000,5
473955900,473955901,947911801,473955904.000000,473955904.000000,947911808.000000,7
475004475,475004476,950008951,475004480.000000,475004480.000000,950008960.000000,9
476053050,476053051,952106101,476053056.000000,476053056.000000,952106112.000000,11
477101625,477101626,954203251,477101632.000000,477101632.000000,954203264.000000,13
478150200,478150201,956300401,478150208.000000,478150208.000000,956300416.000000,15
479198775,479198776,958397551,479198784.000000,479198784.000000,958397568.000000,17
480247350,480247351,960494701,480247360.000000,480247360.000000,960494720.000000,19
481295925,481295926,962591851,481295936.000000,481295936.000000,962591872.000000,21
482344500,482344501,964689001,482344512.000000,482344512.000000,964689024.000000,23
483393075,483393076,966786151,483393088.000000,483393088.000000,966786176.000000,25
484441650,484441651,968883301,484441664.000000,484441664.000000,968883328.000000,27
485490225,485490226,970980451,485490240.000000,485490240.000000,970980480.000000,29
486538800,486538801,973077601,486538816.000000,486538816.000000,973077632.000000,31
487587375,487587376,975174751,487587360.000000,487587360.000000,975174720.000000,31
488635950,488635951,977271901,488635936.000000,488635936.000000,977271872.000000,29
489684525,489684526,979369051,489684512.000000,489684512.000000,979369024.000000,27
490733100,490733101,981466201,490733088.000000,490733088.000000,981466176.000000,25
491781675,491781676,983563351,491781664.000000,491781664.000000,983563328.000000,23
492830250,492830251,985660501,492830240.000000,492830240.000000,985660480.000000,21
493878825,493878826,987757651,493878816.000000,493878816.000000,987757632.000000,19
494927400,494927401,989854801,494927392.000000,494927392.000000,989854784.000000,17
495975975,495975976,991951951,495975968.000000,495975968.000000,991951936.000000,15
497024550,497024551,994049101,497024544.000000,497024544.000000,994049088.000000,13
498073125,498073126,996146251,498073120.000000,498073120.000000,996146240.000000,11
499121700,499121701,998243401,499121696.000000,499121696.000000,998243392.000000,9
500170275,500170276,1000340551,500170272.000000,500170272.000000,1000340544.000000,7
501218850,501218851,1002437701,501218848.000000,501218848.000000,1002437696.000000,5
502267425,502267426,1004534851,502267424.000000,502267424.000000,1004534848.000000,3
503316000,503316001,1006632001,503316000.000000,503316000.000000,1006632000.000000,1
504364575,504364576,1008729151,504364576.000000,504364576.000000,1008729152.000000,1
505413150,505413151,1010826301,505413152.000000,505413152.000000,1010826304.000000,3
506461725,506461726,1012923451,506461728.000000,506461728.000000,1012923456.000000,5
507510300,507510301,1015020601,507510304.000000,507510304.000000,1015020608.000000,7
508558875,508558876,1017117751,508558880.000000,508558880.000000,1017117760.000000,9
509607450,509607451,1019214901,509607456.000000,509607456.000000,1019214912.000000,11
510656025,510656026,1021312051,510656032.000000,510656032.000000,1021312064.000000,13
511704600,511704601,1023409201,511704608.000000,511704608.000000,1023409216.000000,15
512753175,512753176,1025506351,512753184.000000,512753184.000000,1025506368.000000,17
513801750,513801751,1027603501,513801760.000000,513801760.000000,1027603520.000000,19
514850325,514850326,1029700651,514850336.000000,514850336.000000,1029700672.000000,21
515898900,515898901,1031797801,515898912.000000,515898912.000000,1031797824.000000,23
516947475,516947476,1033894951,516947488.000000,516947488.000000,1033894976.000000,25
517996050,517996051,1035992101,517996064.000000,517996064.000000,1035992128.000000,27
519044625,519044626,1038089251,519044640.000000,519044640.000000,1038089280.000000,29
520093200,520093201,1040186401,520093184.000000,520093184.000000,1040186368.000000,33
521141775,521141776,1042283551,521141760.000000,521141760.000000,1042283520.000000,31
522190350,522190351,1044380701,522190336.000000,522190336.000000,1044380672.000000,29
523238925,523238926,1046477851,523238912.000000,523238912.000000,1046477824.000000,27
524287500,524287501,1048575001,524287488.000000,524287488.000000,1048574976.000000,25
525336075,525336076,1050672151,525336064.000000,525336064.000000,1050672128.000000,23
526384650,526384651,1052769301,526384640.000000,526384640.000000,1052769280.000000,21
527433225,527433226,1054866451,527433216.000000,527433216.000000,1054866432.000000,19
528481800,528481801,1056963601,528481792.000000,528481792.000000,1056963584.000000,17
529530375,529530376,1059060751,529530368.000000,529530368.000000,1059060736.000000,15
530578950,530578951,1061157901,530578944.000000,530578944.000000,1061157888.000000,13
531627525,531627526,1063255051,531627520.000000,531627520.000000,1063255040.000000,11
532676100,532676101,1065352201,532676096.000000,532676096.000000,1065352192.000000,9
533724675,533724676,1067449351,533724672.000000,533724672.000000,1067449344.000000,7
534773250,534773251,1069546501,534773248.000000,534773248.000000,1069546496.000000,5
535821825,535821826,1071643651,535821824.000000,535821824.000000,1071643648.000000,3
536870400,536870401,1073740801,536870400.000000,536870400.000000,1073740800.000000,1
537918975,537918976,1075837951,537918976.000000,537918976.000000,1075837952.000000,1
538967550,538967551,1077935101,538967552.000000,538967552.000000,1077935104.000000,3
540016125,540016126,1080032251,540016128.000000,540016128.000000,1080032256.000000,5
541064700,541064701,1082129401,541064704.000000,541064704.000000,1082129408.000000,7
542113275,542113276,1084226551,542113280.000000,542113280.000000,1084226560.000000,9
543161850,543161851,1086323701,543161856.000000,543161856.000000,1086323712.000000,11
544210425,544210426,1088420851,544210432.000000,544210432.000000,1088420864.000000,13
545259000,545259001,1090518001,545259008.000000,545259008.000000,1090518016.000000,15
546307575,546307576,1092615151,546307584.000000,546307584.000000,1092615168.000000,17
547356150,547356151,1094712301,547356160.000000,547356160.000000,1094712320.000000,19
548404725,548404726,1096809451,548404736.000000,548404736.000000,1096809472.000000,21
549453300,549453301,1098906601,549453312.000000,549453312.000000,1098906624.000000,23
550501875,550501876,1101003751,550501888.000000,550501888.000000,1101003776.000000,25
551550450,551550451,1103100901,551550464.000000,551550464.000000,1103100928.000000,27
552599025,552599026,1105198051,552599040.000000,552599040.000000,1105198080.000000,29
553647600,553647601,1107295201,553647616.000000,553647616.000000,1107295232.000000,31
554696175,554696176,1109392351,554696192.000000,554696192.000000,1109392384.000000,33
555744750,555744751,1111489501,555744768.000000,555744768.000000,1111489536.000000,35
556793325,556793326,1113586651,556793344.000000,556793344.000000,1113586688.000000,37
557841900,557841901,1115683801,557841920.000000,557841920.000000,1115683840.000000,39
558890475,558890476,1117780951,558890496.000000,558890496.000000,1117780992.000000,41
559939050,559939051,1119878101,559939072.000000,559939072.000000,1119878144.000000,43
560987625,560987626,1121975251,560987648.000000,560987648.000000,1121975296.000000,45
562036200,562036201,1124072401,562036224.000000,562036224.000000,1124072448.000000,47
563084775,563084776,1126169551,563084800.000000,563084800.000000,1126169600.000000,49
564133350,564133351,1128266701,564133376.000000,564133376.000000,1128266752.000000,51
565181925,565181926,1130363851,565181952.000000,565181952.000000,1130363904.000000,53
566230500,566230501,1132461001,566230528.000000,566230528.000000,1132461056.000000,55
567279075,567279076,1134558151,567279104.000000,567279104.000000,1134558208.000000,57
568327650,568327651,1136655301,568327680.000000,568327680.000000,1136655360.000000,59
569376225,569376226,1138752451,569376256.000000,569376256.000000,1138752512.000000,61
570424800,570424801,1140849601,570424832.000000,570424832.000000,1140849664.000000,63
571473375,571473376,1142946751,571473344.000000,571473344.000000,1142946688.000000,63
572521950,572521951,1145043901,572521920.000000,572521920.000000,1145043840.000000,61
573570525,573570526,1147141051,573570496.000000,573570496.000000,1147140992.000000,59
574619100,574619101,1149238201,574619072.000000,574619072.000000,1149238144.000000,57
575667675,575667676,1151335351,575667648.000000,575667648.000000,1151335296.000000,55
576716250,576716251,1153432501,576716224.000000,576716224.000000,1153432448.000000,53
577764825,577764826,1155529651,577764800.000000,577764800.000000,1155529600.000000,51
578813400,578813401,1157626801,578813376.000000,578813376.000000,1157626752.000000,49
579861975,579861976,1159723951,579861952.000000,579861952.000000,1159723904.000000,47
580910550,580910551,1161821101,580910528.000000,580910528.000000,1161821056.000000,45
581959125,581959126,1163918251,581959104.000000,581959104.000000,1163918208.000000,43
583007700,583007701,1166015401,583007680.000000,583007680.000000,1166015360.000000,41
584056275,584056276,1168112551,584056256.000000,584056256.000000,1168112512.000000,39
585104850,585104851,1170209701,585104832.000000,585104832.000000,1170209664.000000,37
586153425,586153426,1172306851,586153408.000000,586153408.000000,1172306816.000000,35
587202000,587202001,1174404001,587201984.000000,587201984.000000,1174403968.000000,33
588250575,588250576,1176501151,588250560.000000,588250560.000000,1176501120.000000,31
589299150,589299151,1178598301,589299136.000000,589299136.000000,1178598272.000000,29
590347725,590347726,1180695451,590347712.000000,590347712.000000,1180695424.000000,27
591396300,591396301,1182792601,591396288.000000,591396288.000000,1182792576.000000,25
592444875,592444876,1184889751,592444864.000000,592444864.000000,1184889728.000000,23
593493450,593493451,1186986901,593493440.000000,593493440.000000,1186986880.000000,21
594542025,594542026,1189084051,594542016.000000,594542016.000000,1189084032.000000,19
595590600,595590601,1191181201,595590592.000000,595590592.000000,1191181184.000000,17
596639175,596639176,1193278351,596639168.000000,596639168.000000,1193278336.000000,15
597687750,597687751,1195375501,597687744.000000,597687744.000000,1195375488.000000,13
598736325,598736326,1197472651,598736320.000000,598736320.000000,1197472640.000000,11
599784900,599784901,1199569801,599784896.000000,599784896.000000,1199569792.000000,9
600833475,600833476,1201666951,600833472.000000,600833472.000000,1201666944.000000,7
601882050,601882051,1203764101,601882048.000000,601882048.000000,1203764096.000000,5
602930625,602930626,1205861251,602930624.000000,602930624.000000,1205861248.000000,3
603979200,603979201,1207958401,603979200.000000,603979200.000000,1207958400.000000,1
605027775,605027776,1210055551,605027776.000000,605027776.000000,1210055552.000000,1
606076350,606076351,1212152701,606076352.000000,606076352.000000,1212152704.000000,3
607124925,607124926,1214249851,607124928.000000,607124928.000000,1214249856.000000,5
608173500,608173501,1216347001,608173504.000000,608173504.000000,1216347008.000000,7
609222075,609222076,1218444151,609222080.000000,609222080.000000,1218444160.000000,9
610270650,610270651,1220541301,610270656.000000,610270656.000000,1220541312.000000,11
611319225,611319226,1222638451,611319232.000000,611319232.000000,1222638464.000000,13
612367800,612367801,1224735601,612367808.000000,612367808.000000,1224735616.000000,15
613416375,613416376,1226832751,613416384.000000,613416384.000000,1226832768.000000,17
614464950,614464951,1228929901,614464960.000000,614464960.000000,1228929920.000000,19
615513525,615513526,1231027051,615513536.000000,615513536.000000,1231027072.000000,21
616562100,616562101,1233124201,616562112.000000,616562112.000000,1233124224.000000,23
617610675,617610676,1235221351,617610688.000000,617610688.000000,1235221376.000000,25
618659250,618659251,1237318501,618659264.000000,618659264.000000,1237318528.000000,27
619707825,619707826,1239415651,619707840.000000,619707840.000000,1239415680.000000,29
620756400,620756401,1241512801,620756416.000000,620756416.000000,1241512832.000000,31
621804975,621804976,1243609951,621804992.000000,621804992.000000,1243609984.000000,33
622853550,622853551,1245707101,622853568.000000,622853568.000000,1245707136.000000,35
623902125,623902126,1247804251,623902144.000000,623902144.000000,1247804288.000000,37
624950700,624950701,1249901401,624950720.000000,624950720.000000,1249901440.000000,39
625999275,625999276,1251998551,625999296.000000,625999296.000000,1251998592.000000,41
627047850,627047851,1254095701,627047872.000000,627047872.000000,1254095744.000000,43
628096425,628096426,1256192851,628096448.000000,628096448.000000,1256192896.000000,45
629145000,629145001,1258290001,629145024.000000,629145024.000000,1258290048.000000,47
630193575,630193576,1260387151,630193600.000000,630193600.000000,1260387200.000000,49
631242150,631242151,1262484301,631242176.000000,631242176.000000,1262484352.000000,51
632290725,632290726,1264581451,632290752.000000,632290752.000000,1264581504.000000,53
633339300,633339301,1266678601,633339328.000000,633339328.000000,1266678656.000000,55
634387875,634387876,1268775751,634387904.000000,634387904.000000,1268775808.000000,57
635436450,635436451,1270872901,635436480.000000,635436480.000000,1270872960.000000,59
636485025,636485026,1272970051,636485056.000000,636485056.000000,1272970112.000000,61
637533600,637533601,1275067201,637533568.000000,637533568.000000,1275067136.000000,65
638582175,638582176,1277164351,638582144.000000,638582144.000000,1277164288.000000,63
639630750,639630751,1279261501,639630720.000000,639630720.000000,1279261440.000000,61
640679325,640679326,1281358651,640679296.000000,640679296.000000,1281358592.000000,59
641727900,641727901,1283455801,641727872.000000,641727872.000000,1283455744.000000,57
642776475,642776476,1285552951,642776448.000000,642776448.000000,1285552896.000000,55
643825050,643825051,1287650101,643825024.000000,643825024.000000,1287650048.000000,53
644873625,644873626,1289747251,644873600.000000,644873600.000000,1289747200.000000,51
645922200,645922201,1291844401,645922176.000000,645922176.000000,1291844352.000000,49
646970775,646970776,1293941551,646970752.000000,646970752.000000,1293941504.000000,47
648019350,648019351,1296038701,648019328.000000,648019328.000000,1296038656.000000,45
649067925,649067926,1298135851,649067904.000000,649067904.000000,1298135808.000000,43
650116500,650116501,1300233001,650116480.000000,650116480.000000,1300232960.000000,41
651165075,651165076,1302330151,651165056.000000,651165056.000000,1302330112.000000,39
652213650,652213651,1304427301,652213632.000000,652213632.000000,1304427264.000000,37
653262225,653262226,1306524451,653262208.000000,653262208.000000,1306524416.000000,35
654310800,654310801,1308621601,654310784.000000,654310784.000000,1308621568.000000,33
655359375,655359376,1310718751,655359360.000000,655359360.000000,1310718720.000000,31
656407950,656407951,1312815901,656407936.000000,656407936.000000,1312815872.000000,29
657456525,657456526,1314913051,657456512.000000,657456512.000000,1314913024.000000,27
658505100,658505101,1317010201,658505088.000000,658505088.000000,1317010176.000000,25
659553675,659553676,1319107351,659553664.000000,659553664.000000,1319107328.000000,23
660602250,660602251,1321204501,660602240.000000,660602240.000000,1321204480.000000,21
661650825,661650826,1323301651,661650816.000000,661650816.000000,1323301632.000000,19
662699400,662699401,1325398801,662699392.000000,662699392.000000,1325398784.000000,17
663747975,663747976,1327495951,663747968.000000,663747968.000000,1327495936.000000,15
664796550,664796551,1329593101,664796544.000000,664796544.000000,1329593088.000000,13
665845125,665845126,1331690251,665845120.000000,665845120.000000,1331690240.000000,11
666893700,666893701,1333787401,666893696.000000,666893696.000000,1333787392.000000,9
667942275,667942276,1335884551,667942272.000000,667942272.000000,1335884544.000000,7
668990850,668990851,1337981701,668990848.000000,668990848.000000,1337981696.000000,5
670039425,670039426,1340078851,670039424.000000,670039424.000000,1340078848.000000,3
671088000,671088001,1342176001,671088000.000000,671088000.000000,1342176000.000000,1
672136575,672136576,1344273151,672136576.000000,672136576.000000,1344273152.000000,1
673185150,673185151,1346370301,673185152.000000,673185152.000000,1346370304.000000,3
674233725,674233726,1348467451,674233728.000000,674233728.000000,1348467456.000000,5
675282300,675282301,1350564601,675282304.000000,675282304.000000,1350564608.000000,7
676330875,676330876,1352661751,676330880.000000,676330880.000000,1352661760.000000,9
677379450,677379451,1354758901,677379456.000000,677379456.000000,1354758912.000000,11
678428025,678428026,1356856051,678428032.000000,678428032.000000,1356856064.000000,13
679476600,679476601,1358953201,679476608.000000,679476608.000000,1358953216.000000,15
680525175,680525176,1361050351,680525184.000000,680525184.000000,1361050368.000000,17
681573750,681573751,1363147501,681573760.000000,681573760.000000,1363147520.000000,19
682622325,682622326,1365244651,682622336.000000,682622336.000000,1365244672.000000,21
683670900,683670901,1367341801,683670912.000000,683670912.000000,1367341824.000000,23
684719475,684719476,1369438951,684719488.000000,684719488.000000,1369438976.000000,25
685768050,685768051,1371536101,685768064.000000,685768064.000000,1371536128.000000,27
686816625,686816626,1373633251,686816640.000000,686816640.000000,1373633280.000000,29
687865200,687865201,1375730401,687865216.000000,687865216.000000,1375730432.000000,31
688913775,688913776,1377827551,688913792.000000,688913792.000000,1377827584.000000,33
689962350,689962351,1379924701,689962368.000000,689962368.000000,1379924736.000000,35
691010925,691010926,1382021851,691010944.000000,691010944.000000,1382021888.000000,37
692059500,692059501,1384119001,692059520.000000,692059520.000000,1384119040.000000,39
693108075,693108076,1386216151,693108096.000000,693108096.000000,1386216192.000000,41
694156650,694156651,1388313301,694156672.000000,694156672.000000,1388313344.000000,43
695205225,695205226,1390410451,695205248.000000,695205248.000000,1390410496.000000,45
696253800,696253801,1392507601,696253824.000000,696253824.000000,1392507648.000000,47
697302375,697302376,1394604751,697302400.000000,697302400.000000,1394604800.000000,49
698350950,698350951,1396701901,698350976.000000,698350976.000000,1396701952.000000,51
699399525,699399526,1398799051,699399552.000000,699399552.000000,1398799104.000000,53
700448100,700448101,1400896201,700448128.000000,700448128.000000,1400896256.000000,55
701496675,701496676,1402993351,701496704.000000,701496704.000000,1402993408.000000,57
702545250,702545251,1405090501,702545280.000000,702545280.000000,1405090560.000000,59
703593825,703593826,1407187651,703593856.000000,703593856.000000,1407187712.000000,61
704642400,704642401,1409284801,704642432.000000,704642432.000000,1409284864.000000,63
705690975,705690976,1411381951,705690944.000000,705690944.000000,1411381888.000000,63
706739550,706739551,1413479101,706739520.000000,706739520.000000,1413479040.000000,61
707788125,707788126,1415576251,707788096.000000,707788096.000000,1415576192.000000,59
708836700,708836701,1417673401,708836672.000000,708836672.000000,1417673344.000000,57
709885275,709885276,1419770551,709885248.000000,709885248.000000,1419770496.000000,55
710933850,710933851,1421867701,710933824.000000,710933824.000000,1421867648.000000,53
711982425,711982426,1423964851,711982400.000000,711982400.000000,1423964800.000000,51
713031000,713031001,1426062001,713030976.000000,713030976.000000,1426061952.000000,49
714079575,714079576,1428159151,714079552.000000,714079552.000000,1428159104.000000,47
715128150,715128151,1430256301,715128128.000000,715128128.000000,1430256256.000000,45
716176725,716176726,1432353451,716176704.000000,716176704.000000,1432353408.000000,43
717225300,717225301,1434450601,717225280.000000,717225280.000000,1434450560.000000,41
718273875,718273876,1436547751,718273856.000000,718273856.000000,1436547712.000000,39
719322450,719322451,1438644901,719322432.000000,719322432.000000,1438644864.000000,37
720371025,720371026,1440742051,720371008.000000,720371008.000000,1440742016.000000,35
721419600,721419601,1442839201,721419584.000000,721419584.000000,1442839168.000000,33
722468175,722468176,1444936351,722468160.000000,722468160.000000,1444936320.000000,31
723516750,723516751,1447033501,723516736.000000,723516736.000000,1447033472.000000,29
724565325,724565326,1449130651,724565312.000000,724565312.000000,1449130624.000000,27
725613900,725613901,1451227801,725613888.000000,725613888.000000,1451227776.000000,25
726662475,726662476,1453324951,726662464.000000,726662464.000000,1453324928.000000,23
727711050,727711051,1455422101,727711040.000000,727711040.000000,1455422080.000000,21
728759625,728759626,1457519251,728759616.000000,728759616.000000,1457519232.000000,19
729808200,729808201,1459616401,729808192.000000,729808192.000000,1459616384.000000,17
730856775,730856776,1461713551,730856768.000000,730856768.000000,1461713536.000000,15
731905350,731905351,1463810701,731905344.000000,731905344.000000,1463810688.000000,13
732953925,732953926,1465907851,732953920.000000,732953920.000000,1465907840.000000,11
734002500,734002501,1468005001,734002496.000000,734002496.000000,1468004992.000000,9
735051075,735051076,1470102151,735051072.000000,735051072.000000,1470102144.000000,7
736099650,736099651,1472199301,736099648.000000,736099648.000000,1472199296.000000,5
737148225,737148226,1474296451,737148224.000000,737148224.000000,1474296448.000000,3
738196800,738196801,1476393601,738196800.000000,738196800.000000,1476393600.000000,1
739245375,739245376,1478490751,739245376.000000,739245376.000000,1478490752.000000,1
740293950,740293951,1480587901,740293952.000000,740293952.000000,1480587904.000000,3
741342525,741342526,1482685051,741342528.000000,741342528.000000,1482685056.000000,5
742391100,742391101,1484782201,742391104.000000,742391104.000000,1484782208.000000,7
743439675,743439676,1486879351,743439680.000000,743439680.000000,1486879360.000000,9
744488250,744488251,1488976501,744488256.000000,744488256.000000,1488976512.000000,11
745536825,745536826,1491073651,745536832.000000,745536832.000000,1491073664.000000,13
746585400,746585401,1493170801,746585408.000000,746585408.000000,1493170816.000000,15
747633975,747633976,1495267951,747633984.000000,747633984.000000,1495267968.000000,17
748682550,748682551,1497365101,748682560.000000,748682560.000000,1497365120.000000,19
749731125,749731126,1499462251,749731136.000000,749731136.000000,1499462272.000000,21
750779700,750779701,1501559401,750779712.000000,750779712.000000,1501559424.000000,23
751828275,751828276,1503656551,751828288.000000,751828288.000000,1503656576.000000,25
752876850,752876851,1505753701,752876864.000000,752876864.000000,1505753728.000000,27
753925425,753925426,1507850851,753925440.000000,753925440.000000,1507850880.000000,29
754974000,754974001,1509948001,754974016.000000,754974016.000000,1509948032.000000,31
756022575,756022576,1512045151,756022592.000000,756022592.000000,1512045184.000000,33
757071150,757071151,1514142301,757071168.000000,757071168.000000,1514142336.000000,35
758119725,758119726,1516239451,758119744.000000,758119744.000000,1516239488.000000,37
759168300,759168301,1518336601,759168320.000000,759168320.000000,1518336640.000000,39
760216875,760216876,1520433751,760216896.000000,760216896.000000,1520433792.000000,41
761265450,761265451,1522530901,761265472.000000,761265472.000000,1522530944.000000,43
762314025,762314026,1524628051,762314048.000000,762314048.000000,1524628096.000000,45
763362600,763362601,1526725201,763362624.000000,763362624.000000,1526725248.000000,47
764411175,764411176,1528822351,764411200.000000,764411200.000000,1528822400.000000,49
765459750,765459751,1530919501,765459776.000000,765459776.000000,1530919552.000000,51
766508325,766508326,1533016651,766508352.000000,766508352.000000,1533016704.000000,53
767556900,767556901,1535113801,767556928.000000,767556928.000000,1535113856.000000,55
768605475,768605476,1537210951,768605504.000000,768605504.000000,1537211008.000000,57
769654050,769654051,1539308101,769654080.000000,769654080.000000,1539308160.000000,59
770702625,770702626,1541405251,770702656.000000,770702656.000000,1541405312.000000,61
771751200,771751201,1543502401,771751168.000000,771751168.000000,1543502336.000000,65
772799775,772799776,1545599551,772799744.000000,772799744.000000,1545599488.000000,63
773848350,773848351,1547696701,773848320.000000,773848320.000000,1547696640.000000,61
774896925,774896926,1549793851,774896896.000000,774896896.000000,1549793792.000000,59
775945500,775945501,1551891001,775945472.000000,775945472.000000,1551890944.000000,57
776994075,776994076,1553988151,776994048.000000,776994048.000000,1553988096.000000,55
778042650,778042651,1556085301,778042624.000000,778042624.000000,1556085248.000000,53
779091225,779091226,1558182451,779091200.000000,779091200.000000,1558182400.000000,51
780139800,780139801,1560279601,780139776.000000,780139776.000000,1560279552.000000,49
781188375,781188376,1562376751,781188352.000000,781188352.000000,1562376704.000000,47
782236950,782236951,1564473901,782236928.000000,782236928.000000,1564473856.000000,45
783285525,783285526,1566571051,783285504.000000,783285504.000000,1566571008.000000,43
784334100,784334101,1568668201,784334080.000000,784334080.000000,1568668160.000000,41
785382675,785382676,1570765351,785382656.000000,785382656.000000,1570765312.000000,39
786431250,786431251,1572862501,786431232.000000,786431232.000000,1572862464.000000,37
787479825,787479826,1574959651,787479808.000000,787479808.000000,1574959616.000000,35
788528400,788528401,1577056801,788528384.000000,788528384.000000,1577056768.000000,33
789576975,789576976,1579153951,789576960.000000,789576960.000000,1579153920.000000,31
790625550,790625551,1581251101,790625536.000000,790625536.000000,1581251072.000000,29
791674125,791674126,1583348251,791674112.000000,791674112.000000,1583348224.000000,27
792722700,792722701,1585445401,792722688.000000,792722688.000000,1585445376.000000,25
793771275,793771276,1587542551,793771264.000000,793771264.000000,1587542528.000000,23
794819850,794819851,1589639701,794819840.000000,794819840.000000,1589639680.000000,21
795868425,795868426,1591736851,795868416.000000,795868416.000000,1591736832.000000,19
796917000,796917001,1593834001,796916992.000000,796916992.000000,1593833984.000000,17
797965575,797965576,1595931151,797965568.000000,797965568.000000,1595931136.000000,15
799014150,799014151,1598028301,799014144.000000,799014144.000000,1598028288.000000,13
800062725,800062726,1600125451,800062720.000000,800062720.000000,1600125440.000000,11
801111300,801111301,1602222601,801111296.000000,801111296.000000,1602222592.000000,9
802159875,802159876,1604319751,802159872.000000,802159872.000000,1604319744.000000,7
803208450,803208451,1606416901,803208448.000000,803208448.000000,1606416896.000000,5
804257025,804257026,1608514051,804257024.000000,804257024.000000,1608514048.000000,3
805305600,805305601,1610611201,805305600.000000,805305600.000000,1610611200.000000,1
806354175,806354176,1612708351,806354176.000000,806354176.000000,1612708352.000000,1
807402750,807402751,1614805501,807402752.000000,807402752.000000,1614805504.000000,3
808451325,808451326,1616902651,808451328.000000,808451328.000000,1616902656.000000,5
809499900,809499901,1618999801,809499904.000000,809499904.000000,1618999808.000000,7
810548475,810548476,1621096951,810548480.000000,810548480.000000,1621096960.000000,9
811597050,811597051,1623194101,811597056.000000,811597056.000000,1623194112.000000,11
812645625,812645626,1625291251,812645632.000000,812645632.000000,1625291264.000000,13
813694200,813694201,1627388401,813694208.000000,813694208.000000,1627388416.000000,15
814742775,814742776,1629485551,814742784.000000,814742784.000000,1629485568.000000,17
815791350,815791351,1631582701,815791360.000000,815791360.000000,1631582720.000000,19
816839925,816839926,1633679851,816839936.000000,816839936.000000,1633679872.000000,21
817888500,817888501,1635777001,817888512.000000,817888512.000000,1635777024.000000,23
818937075,818937076,1637874151,818937088.000000,818937088.000000,1637874176.000000,25
819985650,819985651,1639971301,819985664.000000,819985664.000000,1639971328.000000,27
821034225,821034226,1642068451,821034240.000000,821034240.000000,1642068480.000000,29
822082800,822082801,1644165601,822082816.000000,822082816.000000,1644165632.000000,31
823131375,823131376,1646262751,823131392.000000,823131392.000000,1646262784.000000,33
824179950,824179951,1648359901,824179968.000000,824179968.000000,1648359936.000000,35
825228525,825228526,1650457051,825228544.000000,825228544.000000,1650457088.000000,37
826277100,826277101,1652554201,826277120.000000,826277120.000000,1652554240.000000,39
827325675,827325676,1654651351,827325696.000000,827325696.000000,1654651392.000000,41
828374250,828374251,1656748501,828374272.000000,828374272.000000,1656748544.000000,43
829422825,829422826,1658845651,829422848.000000,829422848.000000,1658845696.000000,45
830471400,830471401,1660942801,830471424.000000,830471424.000000,1660942848.000000,47
831519975,831519976,1663039951,831520000.000000,831520000.000000,1663040000.000000,49
832568550,832568551,1665137101,832568576.000000,832568576.000000,1665137152.000000,51
833617125,833617126,1667234251,833617152.000000,833617152.000000,1667234304.000000,53
834665700,834665701,1669331401,834665728.000000,834665728.000000,1669331456.000000,55
835714275,835714276,1671428551,835714304.000000,835714304.000000,1671428608.000000,57
836762850,836762851,1673525701,836762880.000000,836762880.000000,1673525760.000000,59
837811425,837811426,1675622851,837811456.000000,837811456.000000,1675622912.000000,61
838860000,838860001,1677720001,838860032.000000,838860032.000000,1677720064.000000,63
839908575,839908576,1679817151,839908544.000000,839908544.000000,1679817088.000000,63
840957150,840957151,1681914301,840957120.000000,840957120.000000,1681914240.000000,61
842005725,842005726,1684011451,842005696.000000,842005696.000000,1684011392.000000,59
843054300,843054301,1686108601,843054272.000000,843054272.000000,1686108544.000000,57
844102875,844102876,1688205751,844102848.000000,844102848.000000,1688205696.000000,55
845151450,845151451,1690302901,845151424.000000,845151424.000000,1690302848.000000,53
846200025,846200026,1692400051,846200000.000000,846200000.000000,1692400000.000000,51
847248600,847248601,1694497201,847248576.000000,847248576.000000,1694497152.000000,49
848297175,848297176,1696594351,848297152.000000,848297152.000000,1696594304.000000,47
849345750,849345751,1698691501,849345728.000000,849345728.000000,1698691456.000000,45
850394325,850394326,1700788651,850394304.000000,850394304.000000,1700788608.000000,43
851442900,851442901,1702885801,851442880.000000,851442880.000000,1702885760.000000,41
852491475,852491476,1704982951,852491456.000000,852491456.000000,1704982912.000000,39
853540050,853540051,1707080101,853540032.000000,853540032.000000,1707080064.000000,37
854588625,854588626,1709177251,854588608.000000,854588608.000000,1709177216.000000,35
855637200,855637201,1711274401,855637184.000000,855637184.000000,1711274368.000000,33
856685775,856685776,1713371551,856685760.000000,856685760.000000,1713371520.000000,31
857734350,857734351,1715468701,857734336.000000,857734336.000000,1715468672.000000,29
858782925,858782926,1717565851,858782912.000000,858782912.000000,1717565824.000000,27
859831500,859831501,1719663001,859831488.000000,859831488.000000,1719662976.000000,25
860880075,860880076,1721760151,860880064.000000,860880064.000000,1721760128.000000,23
861928650,861928651,1723857301,861928640.000000,861928640.000000,1723857280.000000,21
862977225,862977226,1725954451,862977216.000000,862977216.000000,1725954432.000000,19
864025800,864025801,1728051601,864025792.000000,864025792.000000,1728051584.000000,17
865074375,865074376,1730148751,865074368.000000,865074368.000000,1730148736.000000,15
866122950,866122951,1732245901,866122944.000000,866122944.000000,1732245888.000000,13
867171525,867171526,1734343051,867171520.000000,867171520.000000,1734343040.000000,11
868220100,868220101,1736440201,868220096.000000,868220096.000000,1736440192.000000,9
869268675,869268676,1738537351,869268672.000000,869268672.000000,1738537344.000000,7
870317250,870317251,1740634501,870317248.000000,870317248.000000,1740634496.000000,5
871365825,871365826,1742731651,871365824.000000,871365824.000000,1742731648.000000,3
872414400,872414401,1744828801,872414400.000000,872414400.000000,1744828800.000000,1
873462975,873462976,1746925951,873462976.000000,873462976.000000,1746925952.000000,1
874511550,874511551,1749023101,874511552.000000,874511552.000000,1749023104.000000,3
875560125,875560126,1751120251,875560128.000000,875560128.000000,1751120256.000000,5
876608700,876608701,1753217401,876608704.000000,876608704.000000,1753217408.000000,7
877657275,877657276,1755314551,877657280.000000,877657280.000000,1755314560.000000,9
878705850,878705851,1757411701,878705856.000000,878705856.000000,1757411712.000000,11
879754425,879754426,1759508851,879754432.000000,879754432.000000,1759508864.000000,13
880803000,880803001,1761606001,880803008.000000,880803008.000000,1761606016.000000,15
881851575,881851576,1763703151,881851584.000000,881851584.000000,1763703168.000000,17
882900150,882900151,1765800301,882900160.000000,882900160.000000,1765800320.000000,19
883948725,883948726,1767897451,883948736.000000,883948736.000000,1767897472.000000,21
884997300,884997301,1769994601,884997312.000000,884997312.000000,1769994624.000000,23
886045875,886045876,1772091751,886045888.000000,886045888.000000,1772091776.000000,25
887094450,887094451,1774188901,887094464.000000,887094464.000000,1774188928.000000,27
888143025,888143026,1776286051,888143040.000000,888143040.000000,1776286080.000000,29
889191600,889191601,1778383201,889191616.000000,889191616.000000,1778383232.000000,31
890240175,890240176,1780480351,890240192.000000,890240192.000000,1780480384.000000,33
891288750,891288751,1782577501,891288768.000000,891288768.000000,1782577536.000000,35
892337325,892337326,1784674651,892337344.000000,892337344.000000,1784674688.000000,37
893385900,893385901,1786771801,893385920.000000,893385920.000000,1786771840.000000,39
894434475,894434476,1788868951,894434496.000000,894434496.000000,1788868992.000000,41
895483050,895483051,1790966101,895483072.000000,895483072.000000,1790966144.000000,43
896531625,896531626,1793063251,896531648.000000,896531648.000000,1793063296.000000,45
897580200,897580201,1795160401,897580224.000000,897580224.000000,1795160448.000000,47
898628775,898628776,1797257551,898628800.000000,898628800.000000,1797257600.000000,49
899677350,899677351,1799354701,899677376.000000,899677376.000000,1799354752.000000,51
900725925,900725926,1801451851,900725952.000000,900725952.000000,1801451904.000000,53
901774500,901774501,1803549001,901774528.000000,901774528.000000,1803549056.000000,55
902823075,902823076,1805646151,902823104.000000,902823104.000000,1805646208.000000,57
903871650,903871651,1807743301,903871680.000000,903871680.000000,1807743360.000000,59
904920225,904920226,1809840451,904920256.000000,904920256.000000,1809840512.000000,61
905968800,905968801,1811937601,905968768.000000,905968768.000000,1811937536.000000,65
907017375,907017376,1814034751,907017344.000000,907017344.000000,1814034688.000000,63
908065950,908065951,1816131901,908065920.000000,908065920.000000,1816131840.000000,61
909114525,909114526,1818229051,909114496.000000,909114496.000000,1818228992.000000,59
910163100,910163101,1820326201,910163072.000000,910163072.000000,1820326144.000000,57
911211675,911211676,1822423351,911211648.000000,911211648.000000,1822423296.000000,55
912260250,912260251,1824520501,912260224.000000,912260224.000000,1824520448.000000,53
913308825,913308826,1826617651,913308800.000000,913308800.000000,1826617600.000000,51
914357400,914357401,1828714801,914357376.000000,914357376.000000,1828714752.000000,49
915405975,915405976,1830811951,915405952.000000,915405952.000000,1830811904.000000,47
916454550,916454551,1832909101,916454528.000000,916454528.000000,1832909056.000000,45
917503125,917503126,1835006251,917503104.000000,917503104.000000,1835006208.000000,43
918551700,918551701,1837103401,918551680.000000,918551680.000000,1837103360.000000,41
919600275,919600276,1839200551,919600256.000000,919600256.000000,1839200512.000000,39
920648850,920648851,1841297701,920648832.000000,920648832.000000,1841297664.000000,37
921697425,921697426,1843394851,921697408.000000,921697408.000000,1843394816.000000,35
922746000,922746001,1845492001,922745984.000000,922745984.000000,1845491968.000000,33
923794575,923794576,1847589151,923794560.000000,923794560.000000,1847589120.000000,31
924843150,924843151,1849686301,924843136.000000,924843136.000000,1849686272.000000,29
925891725,925891726,1851783451,925891712.000000,925891712.000000,1851783424.000000,27
926940300,926940301,1853880601,926940288.000000,926940288.000000,1853880576.000000,25
927988875,927988876,1855977751,927988864.000000,927988864.000000,1855977728.000000,23
929037450,929037451,1858074901,929037440.000000,929037440.000000,1858074880.000000,21
930086025,930086026,1860172051,930086016.000000,930086016.000000,1860172032.000000,19
931134600,931134601,1862269201,931134592.000000,931134592.000000,1862269184.000000,17
932183175,932183176,1864366351,932183168.000000,932183168.000000,1864366336.000000,15
933231750,933231751,1866463501,933231744.000000,933231744.000000,1866463488.000000,13
934280325,934280326,1868560651,934280320.000000,934280320.000000,1868560640.000000,11
935328900,935328901,1870657801,935328896.000000,935328896.000000,1870657792.000000,9
936377475,936377476,1872754951,936377472.000000,936377472.000000,1872754944.000000,7
937426050,937426051,1874852101,937426048.000000,937426048.000000,1874852096.000000,5
938474625,938474626,1876949251,938474624.000000,938474624.000000,1876949248.000000,3
939523200,939523201,1879046401,939523200.000000,939523200.000000,1879046400.000000,1
940571775,940571776,1881143551,940571776.000000,940571776.000000,1881143552.000000,1
941620350,941620351,1883240701,941620352.000000,941620352.000000,1883240704.000000,3
942668925,942668926,1885337851,942668928.000000,942668928.000000,1885337856.000000,5
943717500,943717501,1887435001,943717504.000000,943717504.000000,1887435008.000000,7
944766075,944766076,1889532151,944766080.000000,944766080.000000,1889532160.000000,9
945814650,945814651,1891629301,945814656.000000,945814656.000000,1891629312.000000,11
946863225,946863226,1893726451,946863232.000000,946863232.000000,1893726464.000000,13
947911800,947911801,1895823601,947911808.000000,947911808.000000,1895823616.000000,15
948960375,948960376,1897920751,948960384.000000,948960384.000000,1897920768.000000,17
950008950,950008951,1900017901,950008960.000000,950008960.000000,1900017920.000000,19
951057525,951057526,1902115051,951057536.000000,951057536.000000,1902115072.000000,21
952106100,952106101,1904212201,952106112.000000,952106112.000000,1904212224.000000,23
953154675,953154676,1906309351,953154688.000000,953154688.000000,1906309376.000000,25
954203250,954203251,1908406501,954203264.000000,954203264.000000,1908406528.000000,27
955251825,955251826,1910503651,955251840.000000,955251840.000000,1910503680.000000,29
956300400,956300401,1912600801,956300416.000000,956300416.000000,1912600832.000000,31
957348975,957348976,1914697951,957348992.000000,957348992.000000,1914697984.000000,33
958397550,958397551,1916795101,958397568.000000,958397568.000000,1916795136.000000,35
959446125,959446126,1918892251,959446144.000000,959446144.000000,1918892288.000000,37
960494700,960494701,1920989401,960494720.000000,960494720.000000,1920989440.000000,39
961543275,961543276,1923086551,961543296.000000,961543296.000000,1923086592.000000,41
962591850,962591851,1925183701,962591872.000000,962591872.000000,1925183744.000000,43
963640425,963640426,1927280851,963640448.000000,963640448.000000,1927280896.000000,45
964689000,964689001,1929378001,964689024.000000,964689024.000000,1929378048.000000,47
965737575,965737576,1931475151,965737600.000000,965737600.000000,1931475200.000000,49
966786150,966786151,1933572301,966786176.000000,966786176.000000,1933572352.000000,51
967834725,967834726,1935669451,967834752.000000,967834752.000000,1935669504.000000,53
968883300,968883301,1937766601,968883328.000000,968883328.000000,1937766656.000000,55
969931875,969931876,1939863751,969931904.000000,969931904.000000,1939863808.000000,57
970980450,970980451,1941960901,970980480.000000,970980480.000000,1941960960.000000,59
972029025,972029026,1944058051,972029056.000000,972029056.000000,1944058112.000000,61
973077600,973077601,1946155201,973077632.000000,973077632.000000,1946155264.000000,63
974126175,974126176,1948252351,974126144.000000,974126144.000000,1948252288.000000,63
975174750,975174751,1950349501,975174720.000000,975174720.000000,1950349440.000000,61
976223325,976223326,1952446651,976223296.000000,976223296.000000,1952446592.000000,59
977271900,977271901,1954543801,977271872.000000,977271872.000000,1954543744.000000,57
978320475,978320476,1956640951,978320448.000000,978320448.000000,1956640896.000000,55
979369050,979369051,1958738101,979369024.000000,979369024.000000,1958738048.000000,53
980417625,980417626,1960835251,980417600.000000,980417600.000000,1960835200.000000,51
981466200,981466201,1962932401,981466176.000000,981466176.000000,1962932352.000000,49
982514775,982514776,1965029551,982514752.000000,982514752.000000,1965029504.000000,47
983563350,983563351,1967126701,983563328.000000,983563328.000000,1967126656.000000,45
984611925,984611926,1969223851,984611904.000000,984611904.000000,1969223808.000000,43
985660500,985660501,1971321001,985660480.000000,985660480.000000,1971320960.000000,41
986709075,986709076,1973418151,986709056.000000,986709056.000000,1973418112.000000,39
987757650,987757651,1975515301,987757632.000000,987757632.000000,1975515264.000000,37
988806225,988806226,1977612451,988806208.000000,988806208.000000,1977612416.000000,35
989854800,989854801,1979709601,989854784.000000,989854784.000000,1979709568.000000,33
990903375,990903376,1981806751,990903360.000000,990903360.000000,1981806720.000000,31
991951950,991951951,1983903901,991951936.000000,991951936.000000,1983903872.000000,29
993000525,993000526,1986001051,993000512.000000,993000512.000000,1986001024.000000,27
994049100,994049101,1988098201,994049088.000000,994049088.000000,1988098176.000000,25
995097675,995097676,1990195351,995097664.000000,995097664.000000,1990195328.000000,23
996146250,996146251,1992292501,996146240.000000,996146240.000000,1992292480.000000,21
997194825,997194826,1994389651,997194816.000000,997194816.000000,1994389632.000000,19
998243400,998243401,1996486801,998243392.000000,998243392.000000,1996486784.000000,17
999291975,999291976,1998583951,999291968.000000,999291968.000000,1998583936.000000,15
1000340550,1000340551,2000681101,1000340544.000000,1000340544.000000,2000681088.000000,13
1001389125,1001389126,2002778251,1001389120.000000,1001389120.000000,2002778240.000000,11
1002437700,1002437701,2004875401,1002437696.000000,1002437696.000000,2004875392.000000,9
1003486275,1003486276,2006972551,1003486272.000000,1003486272.000000,2006972544.000000,7
1004534850,1004534851,2009069701,1004534848.000000,1004534848.000000,2009069696.000000,5
1005583425,1005583426,2011166851,1005583424.000000,1005583424.000000,2011166848.000000,3
1006632000,1006632001,2013264001,1006632000.000000,1006632000.000000,2013264000.000000,1
1007680575,1007680576,2015361151,1007680576.000000,1007680576.000000,2015361152.000000,1
1008729150,1008729151,2017458301,1008729152.000000,1008729152.000000,2017458304.000000,3
1009777725,1009777726,2019555451,1009777728.000000,1009777728.000000,2019555456.000000,5
1010826300,1010826301,2021652601,1010826304.000000,1010826304.000000,2021652608.000000,7
1011874875,1011874876,2023749751,1011874880.000000,1011874880.000000,2023749760.000000,9
1012923450,1012923451,2025846901,1012923456.000000,1012923456.000000,2025846912.000000,11
1013972025,1013972026,2027944051,1013972032.000000,1013972032.000000,2027944064.000000,13
1015020600,1015020601,2030041201,1015020608.000000,1015020608.000000,2030041216.000000,15
1016069175,1016069176,2032138351,1016069184.000000,1016069184.000000,2032138368.000000,17
1017117750,1017117751,2034235501,1017117760.000000,1017117760.000000,2034235520.000000,19
1018166325,1018166326,2036332651,1018166336.000000,1018166336.000000,2036332672.000000,21
1019214900,1019214901,2038429801,1019214912.000000,1019214912.000000,2038429824.000000,23
1020263475,1020263476,2040526951,1020263488.000000,1020263488.000000,2040526976.000000,25
1021312050,1021312051,2042624101,1021312064.000000,1021312064.000000,2042624128.000000,27
1022360625,1022360626,2044721251,1022360640.000000,1022360640.000000,2044721280.000000,29
1023409200,1023409201,2046818401,1023409216.000000,1023409216.000000,2046818432.000000,31
1024457775,1024457776,2048915551,1024457792.000000,1024457792.000000,2048915584.000000,33
1025506350,1025506351,2051012701,1025506368.000000,1025506368.000000,2051012736.000000,35
1026554925,1026554926,2053109851,1026554944.000000,1026554944.000000,2053109888.000000,37
1027603500,1027603501,2055207001,1027603520.000000,1027603520.000000,2055207040.000000,39
1028652075,1028652076,2057304151,1028652096.000000,1028652096.000000,2057304192.000000,41
1029700650,1029700651,2059401301,1029700672.000000,1029700672.000000,2059401344.000000,43
1030749225,1030749226,2061498451,1030749248.000000,1030749248.000000,2061498496.000000,45
1031797800,1031797801,2063595601,1031797824.000000,1031797824.000000,2063595648.000000,47
1032846375,1032846376,2065692751,1032846400.000000,1032846400.000000,2065692800.000000,49
1033894950,1033894951,2067789901,1033894976.000000,1033894976.000000,2067789952.000000,51
1034943525,1034943526,2069887051,1034943552.000000,1034943552.000000,2069887104.000000,53
1035992100,1035992101,2071984201,1035992128.000000,1035992128.000000,2071984256.000000,55
1037040675,1037040676,2074081351,1037040704.000000,1037040704.000000,2074081408.000000,57
1038089250,1038089251,2076178501,1038089280.000000,1038089280.000000,2076178560.000000,59
1039137825,1039137826,2078275651,1039137856.000000,1039137856.000000,2078275712.000000,61
1040186400,1040186401,2080372801,1040186368.000000,1040186368.000000,2080372736.000000,65
1041234975,1041234976,2082469951,1041234944.000000,1041234944.000000,2082469888.000000,63
1042283550,1042283551,2084567101,1042283520.000000,1042283520.000000,2084567040.000000,61
1043332125,1043332126,2086664251,1043332096.000000,1043332096.000000,2086664192.000000,59
1044380700,1044380701,2088761401,1044380672.000000,1044380672.000000,2088761344.000000,57
1045429275,1045429276,2090858551,1045429248.000000,1045429248.000000,2090858496.000000,55
1046477850,1046477851,2092955701,1046477824.000000,1046477824.000000,2092955648.000000,53
1047526425,1047526426,2095052851,1047526400.000000,1047526400.000000,2095052800.000000,51
1048575000,1048575001,2097150001,1048574976.000000,1048574976.000000,2097149952.000000,49
